Level 0
3.0
111111111
2 2 2 2 2
3 3 3 3 3
4 4 4 4 4
5 5 5 5 5